W W W W W W W W W W W W W W W 
W P S S S W S S S S W S S S W 
W W S W S W S W W W S S W D W 
W s S W S W S W S W S W W W W 
W W S W S W N N N W N N N S W 
W S S W S W N W W W W W N W W 
W W S W S W N W N N N W N S W 
W S S W S S N W B N C W N W W 
W S W S W W N N N N N W N S W 
W W S S S W N W W W W W N W W 
W S S W S S N N N N N N N S W 
W W S S W S W S W S W S W D W 
W S W S W S S W S S W S W W W 
W D S S W S W S S W S S S S W 
W W W W W W W W W W W W W W W 