W W W W W W W W W W W W W W W
W S S S W W N N N N N S S S W
W W S W S S N W W W N S W S W
W W S S S W N W N N N W W S W
W S S W W W N W B N C W N D W
W S W P S W N W W W W W W W W
W D W S S W N N W N W N W S W
W W S W S S S W S S S S S S W
W S S W W W S W S W W W S W W
W W S S S W S W W W S W S S W
W S S W S S S S S S S S S W W
W S S W S W S S S W S W S S W
W S W D W S W S W S W S W S W
W S W S S S S S W S S S S S W
W W W W W W W W W W W W W W W
