W W W W W W W W W W W W W W W
W R N I W W S S S S W S S D W
W N N N W W S W W W W S W W W
W W N W W W S W W W W S W W W
W W N S S W S S S S S S S S W
W W W W S W S W W W W S W W W
W W S W S W S W W W W S W W W
T S S S S S S W S S S S S S T
W W W W W W S W W W W S W W W
W W W S W W S W W W W S W W W
W N N N N N P S S S S S S S W
W W W W W N W W W W W S W S W
W C B N W N W W W W W S W S W
W N N N N N D S S S S S S S W
W W W W W W W W W W W W W W W
