W W W W W W W W W W W W W W W
W P S S S W S S S S S S S S W
W W S W S W S W W W S W W D W
W S S S S W S S S S W S W W W
W W W W S W S S W S S S S S W
W S S S S S W N N N W N N S W
W W S S S W N W W W W W N W W
W S S W S S N W N N C W N W W
W S W S S W N W B N N N N S W
W S S W S W N W W W W W W S W
W S S S S S N N N N N N W S W
W W S W S W S W S W S W S S W
W S W S W S S S W S S W S W W
W D S S S S W S W W S S S D W
W W W W W W W W W W W W W W W