W W W W W W W W W W W W W W W
W S S S D S S S S S W S S S W
W W W S W S W W W S W S W S W
W S S S W S S S W S S S W S W
W S W W W S W S W W W W W S W
W S S S N N N N N N N S D S T
W W W S N W W B W W N S D S W
W S W S N W C R I W N S W S W
W S W S N W W W W W N S W S W
W S W S N N N P N N N S W S W
W S W W W S W W W W W S W S W
W S S S W S S S S S S S W S W
W S W S W W W W W W W W W S W
T S W S S S S S S S S S S S W
W W W W W W W W W W W W W W W