W W W W W W W W W W W W W W W
W P S S S S W S W S S W S S W
W W W W S W W S S S W S W S W
W S S S S S W S W S S S S S W
W W S S W N N N N W W S W S W
W W S W N W W W N W N N W S W
W S S S N W B N W W W N W S W
W S W W N W C N N N N S W W W
W S S W N W W W W N W S S S W
W W S S N N N W W W W S W S W
W S S W W W S S S S W S S S W
W S W S S W S W S S S W S W W
W S W S W D W W S W S S S W W
W S S S S S S W S W W S W D W
W W W W W W W W W W W W W W W
