W W W W W W W W W W W W W W W
W D S W S S S S W S S S W S W
W W S W S W S W S W S S S S W
W S S W S W S W S W W S W W W
W W S W S W N N N N N N S S W
W S S W S W N W W W W N W S W
W W S W S W N W C N W N W W W
W S S S S S N W I R N N S D W
W W S W S W N W B N W N S W W
W S W S W S N W W W W N W W W
W P S S S S N N N W N N S S W
W W S W W S W W S W W S W S W
W W S W S S W S W W S S W S W
W D S S S S S S S S S S S S W
W W W W W W W W W W W W W W W
