W W W W W W W W W W W W W W W
W P S S S S W S W S S W S S W
W W W W S W W S S S W S W S W
W S S S S S W S W S S S S S W
W W S S W S S S S W W S W S W
W W S W S W W W S W S S W S W
W S S S S W B N W W W S W S W
W S W W S W C N N N S S W W W
W S S W S W W W W S W S S S W
W W S S W S S W W W W S W S W
W S S W W W S S S S W S S S W
W S W S S W S W S S S W S W W
W S W S W D W W S W S S S W W
W S S S S S S W S W W S W D W
W W W W W W W W W W W W W W W
