W W W W W W W W W W W W W W W 
W S S S W S W S S S S S W S W 
W W W S W S W S W S W S W S W 
W S W S W S W S W S W S W S W 
W S W S W S W S W S W S W S W 
W S S S N N N N N N N S S S W 
W S W W N S W B W S N W W S W 
W S S S N S C R I S N S W S W 
W W W S N W W W W W N S W S W 
W S W S N N N P N N N S W S W 
W S W W W W W W W W W W W S W 
W S S S W S S S S S S S S S W 
W S W S W S W W W W W W W W W 
W S W S S S S S S S S S S S W 
W W W W W W W W W W W W W W W