W W W W W W W W W W W W W W W
W D S S S W S S S S W S S S W
W W S W S S S W W S W S W S W
W W S W S W S W W W P S W S W
W W S S S W N N N N N N N S W
W W S W S W N W W W W W N W W
W W S W S W N W W W W W N S W
W S S S S S N W N N N N N S W
W W S W S W N W N C B W N W W
W W W S W W N W W W W W N W W
W S S S S S N N N N N N N S W
W S W S W S W S W S W S W S W
W W S W W S W W S W W S W S W
W D S S S S S S S S S S S S W
W W W W W W W W W W W W W W W
