W W W W W W W W W W W W W W W
W S S S W W S S S S S S S S W
W W S W S S S W W W N S W S W
W W S S S W S W N N N W W S W
W S S W W W S W B N C W D S W
W S W P S W S W W W W W W W W
W D W S S W S S W S W S W S W
W W S W S S S W S S S S S S W
W S S W W W S W S W W W S W W
W W S S S W S W W W S W S S W
W S S W S S S S S S S S S W W
W S S W S W S S S W S W S S W
W S W D W S W S W S W S W S W
W S W S S S S S W S S S S S W
W W W W W W W W W W W W W W W
