W W W W W W W W W W W W W W W
W D S W S S S S W S S S W S W
W W S W S W S W S W S S S S W
W S S W S W S W S W W S W W W
W W S W S W S S S S S S S S W
W S S W S W S W W W W S W S W
W W S W S W S W C N W S W W W
W S S S S S S W N N N S S D W
W W S W S W S W B N W S S W W
W S W S W S S W W W W S W W W
W P S S S S S S S W S S S S W
W W S W W S W W S W W S W S W
W W S W S S W S W W S S W S W
W D S S S S S S S S S S S S W
W W W W W W W W W W W W W W W
