W W W W W W W W W W W W W W W
W S W S S S S S W S S S S S W
W S W W W S W S W S W W W S W
W S S S W S W S W S W S W S W
W W W S W S W S W S W S W S W
W S S S N N N N N N N S S S T
W S W W N W W B W W N S W W W
W S W S N W C R I W N S S S W
T S W S N W W W W W N W W S W
W S S S N N N P N N N S W S W
W W W D W S W W W W W D W S W
W S S S W S S S S S S S S S W
W S W S W S W W W D W W W W W
W S W S S S S S S S S S S S W
W W W W W W W W W W W W W W W