W W W W W W W W W W W W W W W
W S S S S W S S W S S S S S W
W W S W S S S W S S W S W S W
W W S W S W S W S W W S W S W
W S S W S W S S W S S S S S W
W D W W S S S W W S W S W S W
W W S W S W S W S S W W S W W
W S S S S S S S S W S S S S W
W S W S W W S W S S S W S W W
W W S W S W S W W W W W S W W
W S S P S S S W S S S S S S W
W W S W S S W W D W W W W S W
W D W S W S W S W N N B W S W
W S S S S S S S S W C N N N W
W W W W W W W W W W W W W W W
