W W W W W W W W W W W W W W W
W P S S S W S S S S S S S S W
W W S W S W S W W W S W W D W
W S S S S W S S S S W S W W W
W W W W S W S S W S S S S S W
W S S S S S W S S S W S S S W
W W S S S W S W W W W W S W W
W S S W S S S W N N C W S W W
W S W S S W S W B N N N S S W
W S S W S W S W W W W W W S W
W S S S S S S S S S S S W S W
W W S W S W S W S W S W S S W
W S W S W S S S W S S W S W W
W D S S S S W S W W S S S D W
W W W W W W W W W W W W W W W