W W W W W W W W W W W W W W W
W S S S S W S S W S S S S S W
W W S W S S S W S S W S W S W
W W S W S W S W S W W S W S W
W S S W S W S S W S S S S S W
W D W W S S S W W S W S W S W
W W S W S W S W S S W W S W W
W S S S S S S S S W S S S S W
W S W S W W S W S S S W S W W
W W S W S W S W W W W W S W W
W S S P S S S W N N N N N N W
W W S W S S W W N W W W W N W
W D W S W S W N W N N B W N W
W S S S S S S S N W C N N N W
W W W W W W W W W W W W W W W
