W W W W W W W W W W W W W W W
W S S S S W S S W S S S W D W
W W S W S W S S W S W S W S W
W S S W S S S W W W W S W S W
W W S W S W S S S S S S S S W
W S S W S S S W S W W S W W W
W W S W W W S W S W W W W W W
W S S W S S S W S W S S S S W
W W S W W W S W S W D W S W W
W S S W P W S W W W W W S W W
W W S W S S S S S S S S S S W
W S S W W W W W S W S S W S W
W W S W N N N W S W W S W S W
W D S S B N C W S S S S S S W
W W W W W W W W W W W W W W W
