W W W W W W W W W W W W W W W
W S S S S W S S W S S S W D W
W W S W S W S S W S W S W S W
W S S W S S S W W W W S W S W
W W S W S W S S S S S S S S W
W S S W S S S W S W W S W W W
W W S W W W S W S W W W W W W
W S S W S S S W S W S S S S W
W W S W W W S W S W D W S W W
W S S W P W S W W W W W S W W
W W N W N N N N N S S S S S W
W S N W W W W W N W S S W S W
W W N W N N N W N W W S W S W
W D N N B N C W N S S S S S W
W W W W W W W W W W W W W W W
